######################################################################
#....................................................................#
#....................................................................#
#....................................................................#
#....................................................................#
#....................................................................#
#....................................................................#
#....................................................................#
#....................................................................#
#....................................................................#
#....................................................................#
#....................................................................#
#....................................................................#
#....................................................................#
#....................................................................#
#....................................................................#
#..................###########################.......................#
#..................#.........................#.......................#
#..................#.........................#.......................#
#..................#.........................#.......................#
#..................#.........................#.......................#
#..................#.........................#.......................#
#..................#.........................#.......................#
#..................#.........................#.......................#
#..................#.........................#.......................#
#..................#............@............#.......................#
#..................#.........................#.......................#
#..................#.........................#.......................#
#..................#.........................#.......................#
#..................#.........................#.......................#
#..................#.........................#.......................#
#..................#.........................#.......................#
#..................#.........................#.......................#
#..................#.........................#.......................#
#..................###########################.......................#
#....................................................................#
#....................................................................#
#....................................................................#
#....................................................................#
#....................................................................#
#....................................................................#
#....................................................................#
#....................................................................#
#....................................................................#
#....................................................................#
#....................................................................#
#....................................................................#
#....................................................................#
#....................................................................#
######################################################################
