######################################################################
#....................................................................#
#....................................................................#
#....................................................................#
#....................................................................#
#....................................................................#
#....................................................................#
#....................................................................#
#....................................................................#
#....................................................................#
#....................................................................#
#....................................................................#
#....................................................................#
#....................................................................#
#....................................................................#
#....................................................................#
#....................................................................#
#....................................................................#
#....................................................................#
#....................................................................#
#....................................................................#
#...................................@................................#
#....................................................................#
#....................................................................#
#....................................................................#
#....................................................................#
#....................................................................#
#....................................................................#
#....................................................................#
#....................................................................#
#....................................................................#
#....................................................................#
#....................................................................#
#....................................................................#
#....................................................................#
#....................................................................#
#....................................................................#
#....................................................................#
#....................................................................#
#....................................................................#
#....................................................................#
#....................................................................#
#....................................................................#
#....................................................................#
#....................................................................#
#....................................................................#
#....................................................................#
#....................................................................#
#....................................................................#
######################################################################