######################################################################
#....................................................................#
#....................................................................#
#....................................................................#
#....................................................................#
#....................................................................#
#....................................................................#
#....................................................................#
#....................................................................#
#....................................................................#
#....................................................................#
#....................................................................#
#....................................................................#
#....................................................................#
#....................................................................#
#....................................................................#
#....................###########################.....................#
#....................#.........................#.....................#
#....................#.........................#.....................#
#....................#.........................#.....................#
#....................#.........................#.....................#
#....................#.........................#.....................#
#....................#.........................#.....................#
#....................#.........................#.....................#
#....................#.........................#.....................#
#....................#............@............#.....................#
#....................#.........................#.....................#
#....................#.........................#.....................#
#....................#.........................#.....................#
#....................#.........................#.....................#
#....................#.........................#.....................#
#....................#.........................#.....................#
#....................#.........................#.....................#
#....................#.........................#.....................#
#....................###########################.....................#
#....................................................................#
#....................................................................#
#....................................................................#
#....................................................................#
#....................................................................#
#....................................................................#
#....................................................................#
#....................................................................#
#....................................................................#
#....................................................................#
#....................................................................#
#....................................................................#
#....................................................................#
#....................................................................#
######################################################################